{0,1,2,3,4,5,0,0,1,0,0,5,4,3,2,1},
{0,2,3,4,5,0,0,1,2,1,0,0,5,4,3,2},
{0,3,4,5,0,0,1,2,3,2,1,0,0,5,4,3},
{0,4,5,0,0,1,2,3,4,3,2,1,0,0,5,4},
{0,5,0,0,1,2,3,4,5,4,3,2,1,0,0,5},
{0,0,0,1,2,3,4,5,6,5,4,3,2,1},
{0,0,1,2,3,4,5,6,7,6,5,4,3,2,1},
{0,1,2,3,4,5,6,7,8,7,6,5,4,3,2,1},
{0,0,1,2,3,4,5,6,7,6,5,4,3,2,1},
{0,0,0,1,2,3,4,5,6,5,4,3,2,1},
{0,5,0,0,1,2,3,4,5,4,3,2,1,0,0,5},
{0,4,5,0,0,1,2,3,4,3,2,1,0,0,5,4},
{0,3,4,5,0,0,1,2,3,2,1,0,0,5,4,3},
{0,2,3,4,5,0,0,1,2,1,0,0,5,4,3,2},
{0,1,2,3,4,5,0,0,1,0,0,5,4,3,2,1}
